AsuAsuAsuAsuAsuAsuAsuAsuAsuAsuAsuAsuAsuAsuAsuAsuAsuAsuAsuAsuAsuAsuAsuAsu
AsuAsuAsuAsuAsuAsuAsuAsuAsuAsuAsuAsuIjiIkiIjiIkiAsuAsuAsuAsuAsuAsuAsuAsu
AsuAsuAsuAsuAsuAsuAsuAsuAsuAsuIagIbgIcgIdgIegAsuIlgImgIneAsuAsuAsuAsuAsu
AsuAsuAsuAsuAsuAsuAsuAsuAsuAsuIahIbhIchIdhIehAsuIlhImhInfAsuAsuAsuAsuAsu
AsuAsuAsuAsuAsuIoiIpiAsuIfaAsuIaiIbiIciIdiIeiAsuAsuAsuAsuAsuAsuAsuAsuAsu
AsuAsuIobIpjAsuIojIpjAsuAsuAsuAsuAsuAsuAsuAsuAsuAsuAsuAsuAsuAsuAsuImdAsu
AsuAsuAsuAsuAsuAsuAsuAsuAsuAsuAsuAsuAsuAsuAsuAsuAsuAsuAsuAsuAsuAsuAsuAsu
AsuAsuAsuAsuAsuAsuAsuAsuAsuAsuAsuIkhAsuAsuAsuAsuAsuIkhAsuAsuAsuAsuAsuAsu
AsuAsuAsuAsuAsuAsuAsuAsuAsuAsuAsuAsuAsuAsuAsuAsuAsuAsuAsuAsuAsuAsuAsuAsu
AsuAsuAsuAsuAsuAsuAsuAsuAsuAsuAsuIijAsuAsuAsuAsuAsuAsuAsuAsuAsuAsuAsuAsu
AsuAsuAsuAsuAsuAsuAsuAsuAsuAsuAsuAsuAsuAsuAsuAsuAsuAsuAsuAsuAsuAsuAsuAsu
AsuAsuAsuAsuAsuAsuAsuAsuAsuAsuAsuAsuAsuAsuAsuAsuAsuAsuAsuAsuAsuAsuAsuAsu
AsuAsuAsuAsuAsuAsuAsuAsuAsuAsuAsuIkhAsuAsuAsuAsuAsuIkhAsuAsuAsuAsuAsuAsu
AsuAsuAsuAsuAsuAsuAsuAsuAsuAsuAsuAsuAsuAsuAsuAsuAsuAsuAsuAsuAsuAsuAsuAsu
