AcbAcbAcbAcbAcbAcbAcbAcbAcbAcbAobApbAtbAubFbbAubAvbAnbAobAcbAcbAcbAcbAcb
AcbAcbAcbAcbAcbAcbAcbAcbAcbAcbAobApbAtbAubFbbAubAvbAnbAobAcbAcbAcbAcbAcb
AcbAcbAcbAcbAcbAcbAcbAcbAcbAcbAobApbAtbAubFbbAubAvbAnbAobAcbAcbAcbAcbAcb
AcbAcbAcbAcbAcbAcbAcbAcbAcbAcbAobApbAtbAubFbbAubAvbAnbAobAcbAcbAcbAcbAcb
AcbAcbAcbAcbAcbAcbAcbAcbAcbAcbAobApbAtbAubFbbAubAvbAnbAobAcbAcbAcbAcbAcb
AcbAcbAcaAcaAcaAcaAcaAcaAcaAcaAobApbAtbAubFbbAubAvbAnbAobAcaAcaAcaAcaAca
AcbAcbAcbAcbAcbAcbAcbAcbAcbAcbAobApbAtbHaaFbbHaeAvbAnbAobAcbAcbAcbAcbAcb
AcbAcbAcbAcbAcbAcbAcbAcbAcbAcbAobApbAtbAubFbbAubAvbAnbAobAcbAcbAcbAcbAcb
AcbAcbAcbAcbAcbAcbAcbAcbAcbAcbAobApbAtbAubFbbAubAvbAnbAobAcbAcbAcbAcbAcb
AcbAcbAcbAcbAcbAcbAcbAcbAcbAcbAobApbAtbAubFbbAubAvbAnbAobAcbAcbAcbAcbAcb
AcbAcbAcbAcbAcbAcbAcbAcbAcbAcbAobApbAtbAubFbbAubAvbAnbAobAcbAcbAcbAcbAcb
AcbAcbAcbAcbAcbAcbAcbAcbIpmAcbAobApbAtbAubFbbAubAvbAnbAobAcbAcbAcbAcbAcb
AcbAcbAcbAcbAcbAcbAcbAcbAcbAcbAobApbAtbHaeFbbAubAvbAnbAobAcbAcbAcbAcbAcb
AcbAcbAcbAcbAcbAcbAcbAcbAcbAcbAobApbAtbAubFbbAubAvbAnbAobAcbAcbAcbAcbAcb
