AsuAsuAsuAsuAsuIcbAsuAsuAsuAsuAsuAsuAsuAsuAsuAsuAsuAsuAsuAsuAsuAsuAsuAsu
AsuAsuAsuAsuAsuAsuAsuAsuAsuAsuAsuAsuAsuAsuAsuAsuAsuAsuAsuAsuAsuAsuAsuAsu
AsuAsuAsuAsuAsuAsuAsuAsuAsuAsuAsuAsuAsuAsuAsuAsuAsuAsuAwwAsuAsuAsuAsuAsu
AsuAsuAsuAsuAsuAsuAsuAsuAsuAsuAsuAsuAsuAsuAsuAsuAsuAsuAsuAsuAsuAsuAsuAsu
AsuAsuIoiIpiAsuAsuAsuAsuAsuAsuAsuIifIjfAsuAsuAsuIjeIkeAsuAsuAsuAsuImcAsu
AsuAsuAsuAsuAsuAsuAsuAsuAsuAsuAsuIkfAsuAsuAsuAsuAsuIkfAsuAsuAsuAsuAsuAsu
AsuAsuAsuAsuAsuAsuAsuAsuAsuAsuAsuIkgAsuAsuAsuAsuAsuIkgAsuAsuAsuAsuAsuAsu
AsuAsuDosDpsDpsDpsDpsDpsDpsDrsAsuAsuAsuAsuAsuAsuAsuAsuAsuAsuAsuAsuAsuAsu
AsuAsuAsuAsuAsuAsuAsuAsuAsuAsuAsuIiiAsuAsuAsuAsuAsuAsuAsuAsuAsuAsuAsuAsu
IcbAsuAsuAsuAsuAsuAsuAsuAsuAsuAsuIifIjfAsuAsuAsuIjeIkeAsuDbkDckDckDckDck
AsuAsuAsuAsuAsuAsuAsuAsuAsuAsuAsuIkfAsuAsuAsuAsuAsuIkfAsuAsuAsuAsuAsuAsu
AsuAsuAsuAsuAsuAsuAsuAsuAsuAsuAsuIkgAsuAsuAsuAsuAsuIkgAsuAsuAsuAsuAsuJgc
AsuAsuAsuAsuAsuAsuAsuAsuAsuAsuAsuAsuAsuAsuAsuAsuAsuAsuAsuAsuAsuAsuAsuAsu
AsuAsuAsuAsuAsuAsuAsuAsuAsuAsuAsuAsuAsuAsuAsuAsuAsuAsuAsuAsuAsuAsuAsuAsu
