AxwGnoGooAxwAxwAxwAxwAxwAxwAxwAxwAxwAxwAxwAxwAxwAxwAxwAxwAxwAxwAxwAxwAxw
AxwAxwAxwAxwAxwAxwAxwAxwAxwAxwAxwAxwAxwAxwAxwAxwAxwAxwAxwAxwAxwAxwAxwAxw
AxwAxwAxwAxwAxwAxwAxwAxwAxwAxwAxwAxwAxwAxwAxwAxwAxwAxwAxwAxwAxwAxwAxwAxw
AxwAxwAxwAxwAxwAxwAxwAxwAxwAxwAxwAxwAxwAxwAxwAxwAxwAxwAxwAxwAxwAxwAxwAxw
AxwAxwAxwAxwAxwAxwAxwAxwAxwAxwAxwAxwAxwAxwAxwAxwAxwAxwAxwAxwAxwAxwAwvAxw
AxwAxwAxwAxwAxwAxwAxwAxwAxwAxwAxwAxwAxwAxwAxwAxwAxwAxwAxwAxwAxwAxwAsuAxw
AxwAxwAxwAxwAxwAxwAxwAxwAxwAxwAxwAxwAxwAxwAxwAxwAxwAxwAxwAxwAxwAxwAxwAxw
AxwAxwAxwGkmGlmGmmAxwAxwAxwAxwAxwAxwAxwAxwAxwAxwAxwAxwAxwAxwAxwAxwAxwAxw
AxwAxwAxwGknGlnGmnAxwAsuGkkAxwAxwAxwAxwAxwAxwAxwAxwAxwAxwAxwAxwAxwAxwAxw
AxwAxwAxwAsuAsuAsuAxwAsuGklAxwAxwAxwAxwAxwAxwAxwAxwAxwAxwAxwAxwGpkAxwAxw
AxwAxwAxwAsuAsuAsuAxwAxwAxwAxwAxwAxwAxwAxwAxwAxwAxwAxwAxwAxwAxwGplAxwAxw
AxwAxwAxwAxwAxwAxwAxwAxwAxwAxwAxwAxwAxwAxwAxwAxwAxwAxwAxwAxwAxwAxwAxwAxw
AxwAxwAxwAxwAxwAxwAxwAxwAxwAxwAxwAxwAxwAxwAxwAxwAxwAxwAxwAxwAxwAxwAxwAxw
AxwAxwAxwAxwAxwAxwAxwAxwAxwAxwAxwAxwAxwAxwAxwAxwAxwAxwAxwAxwAxwAxwAxwAxw
