AsuAsuAsuAsuAsuAsuAsuAsuAsuAsuAsuAsuAsuAsuAsuAsuAsuAsuAsuAsuAsuAsuAsuAsu
AsuAsuAsuAsuAsuAsuAsuAsuAsuAsuAsuAsuAsuAsuAsuAsuAsuAsuAsuAsuAsuAsuAsuAsu
AsuAsuAsuAsuAsuAsuAsuAsuAsuAsuAsuAsuAsuAsuAsuAsuAsuAsuAsuAsuAsuAsuAsuAsu
AsuAsuAsuAsuAsuAsuAsuAsuAsuAsuAsuShjAsuAsuAsuAsuAsuAsuAsuAsuAsuAsuAsuAsu
AsuAsuAsuAsuAsuAsuAsuSjeAsuAsuAsuShkAsuAsuAsuAsuUieAsuAsuAsuAsuAsuAsuAsu
AsuAsuAsuAsuAsuAsuAsuSifAsuAsuAsuShlAwwAsuQeeAsuUifAsuAsuAsuAsuAsuAsuAsu
AsuAsuAsuAsuAsuAsuAsuAsuAsuAsuAsuAsuAsuAsuQefAsuUigAsuAsuAsuAsuAsuAsuAsu
AsuAsuAsuAsuAsuAsuAsuAsuAsuAsuAsuAsuAsuAsuAsuAsuAsuAsuAsuAsuAsuAsuAsuAsu
AsuAsuAsuAsuAsuAsuAsuAsuAsuAsuAwwAsuAsuAsuAsuAsuAsuAsuAsuAsuAsuAsuAsuAsu
AsuAsuAsuAsuAsuAsuAsuAsuAsuAsuAsuAsuAsuAsuAsuAsuAsuAsuAsuAsuAsuAsuAsuAsu
AsuAsuAsuAsuAsuAsuAsuAsuAsuAsuAsuAsuAsuAsuAsuAsuAsuAsuAsuAsuAsuAsuAsuAsu
AsuAsuAsuAsuAsuAsuAsuAsuAsuAsuAsuAsuAsuAsuAsuAsuAsuAsuAsuAsuAsuAsuAsuAsu
AsuAsuAsuAsuAsuAsuAsuAsuAsuAsuAsuAsuAsuAsuAsuAsuAsuAsuAsuAsuAsuAsuAsuAsu
AsuAsuAsuAsuAsuAsuAsuAsuAsuAsuAsuAsuAsuAsuAsuAsuAsuAsuAsuAsuAsuAsuAsuAsu
