AsuAsuAsuAsuAsuAsuAsuAsuAsuAsuAsuAsuAsuAsuAsuAsuAsuAsuAsuAsuAsuAsuAsuAsu
AsuAsuAsuAsuAsuAsuAsuAsuAsuAsuAsuAsuAsuAsuAsuAsuAsuAsuAsuAsuAsuAsuAsuAsu
AsuAsuAsuAsuAsuAsuPdaPgiPgiPgiPgiPgiPgiPgiPgiPgiPgiPeaAsuAsuAsuAsuAsuAsu
AsuAsuAsuAsuAsuAsuPadPbfPcfPcfPcfPcfPcfPcfPcfPcfPefPadAsuAsuAsuAsuAsuAsu
AsuAsuAsuAsuAsuAsuPadPbhPchPchPchPchPchPchPchPchPehPadAsuAsuAsuAsuAsuAsu
AsuAsuAsuAsuAsuAsuPadAsuAsuAsuAsuAsuAsuAsuAsuAsuAsuPadAsuAsuAsuAsuAsuAsu
AsuAsuAsuAsuAsuAsuPadAsuAsuAsuAsuAsuAsuAsuAsuAsuAsuPadAsuAsuAsuAsuAsuAsu
AsuAsuAsuAsuAsuAsuPadAsuAsuAsuAsuAsuAsuAsuAsuAsuAsuPadAsuAsuAsuAsuAsuAsu
AsuAsuAsuAsuAsuAsuPadAsuAsuAsuAsuAsuAsuAsuAsuAsuAsuPadAsuAsuAsuAsuAsuAsu
AsuAsuAsuAsuAsuAsuPdbAsuAsuAsuAsuAsuAsuAsuAsuAsuAsuPebAsuAsuAsuAsuAsuAsu
AsuAsuAsuAsuAsuAsuAsuAswAswAswAswAswAswAswAswAswAswAsuAsuAsuAsuAsuAsuAsu
AsuAsuAsuAsuAsuAsuAsuAsuAsuAsuAsuAsuAsuAsuAsuAsuAsuAsuAsuAsuAsuAsuAsuAsu
AsuAsuAsuAsuAsuAsuAsuAsuAsuAsuAsuAsuAsuAsuAsuAsuAsuAsuAsuAsuAsuAsuAsuAsu
AsuAsuAsuAsuAsuAsuAsuAsuAsuAsuAsuAsuAsuAsuAsuAsuAsuAsuAsuAsuAsuAsuAsuAsu
