AsuAsuAsuAsuAsuAsuAsuAsuAsuAsuAsuAsuAsuAsuAsuAsuAsuAsuAsuAsuAsuAsuAsuAsu
AsuAsuAsuAsuAsuAsuAsuAsuAsuAsuAsuAsuAsuAsuAsuAsuAsuAsuAsuAsuAsuAsuAsuAsu
AsuAsuAsuAsuAsuAsuAsuAsuAsuAsuAsuAsuAsuAsuAsuAsuAsuAsuAsuAsuAsuAsuAsuAsu
AsuAsuAsuAsuAsuAsuAsuAsuAsuAsuAsuAsuAsuAsuAsuAsuAsuAsuAsuAsuAsuAsuAsuAsu
AsuAsuAsuAsuAsuAsuAsuAsuAsuAsuAsuAsuAsuAsuAsuAsuAsuAsuAsuAsuAsuAsuAsuAsu
AsuAsuAsuAsuAsuAsuAsuAsuAsuAsuAsuAsuAsuAsuAsuAxwAsuAsuAsuAsuAsuAsuAsuAsu
AsuAsuAsuAsuAsuAsuAxvQoaQpaTgbAxvQoaQpaAsuAsuAsuAsuAsuAsuAsuAsuAsuAsuAsu
AsuAsuAsuAsuAsuAsuTlbQobQpbTchTdhQobQpbAsuTdgAsuAsuAsuAsuAsuAsuAsuAsuAsu
AsuAsuAsuAsuAsuAsuAsuAsuAsuAsuAsuAsuAsuAsuAsuAsuAsuAsuAsuAsuAsuAsuAsuAsu
AsuAsuAsuAsuAsuAsuTagAsuAsuAsuAsuAsuAsuAsuAsuAsuAsuAsuAsuAsuAsuAsuAsuAsu
AsuAsuAsuAsuAsuAgvAgvAsuAsuAsuAsuAsuAsuAsuAsuTcgAsuAsuAsuAsuAsuAsuAsuAsu
AsuAsuAsuAsuAsuAsuAsuAsuAsuAsuAsuAsuAsuAsuAsuAsuAsuAsuAsuAsuAsuAsuAsuAsu
AsuAsuAsuAsuAsuAsuAsuAsuAsuAsuAsuAsuAsuAsuAsuAsuAsuAsuAsuAsuAsuAsuAsuAsu
AsuAsuAsuAsuAsuAsuAsuAsuAsuAsuAsuAsuAsuAsuAsuAsuAsuAsuAsuAsuAsuAsuAsuAsu
