AsuAsuAsuAsuAsuAsuAsuAsuAsuAsuAsuAsuAsuAsuAsuAsuAsuAsuAsuAsuAsuAsuAsuAsu
AsuAsuAsuAsuAsuAsuAsuAsuAsuAsuAsuAsuAsuAsuAsuAsuAsuAsuAsuAsuAsuAsuAsuAsu
AsuAsuAsuAsuAsuAsuAsuAsuAsuAsuAsuAsuAsuAsuAsuAsuAsuAsuAsuAsuAsuAsuAsuAsu
AsuAsuAsuAsuAsuAsuAsuAsuAsuAsuAsuAsuAsuAsuAsuAsuAsuAsuAsuAsuAsuAsuAsuAsu
AsuAsuAsuAsuAsuAsuAsuAsuAsuAsuAsuAsuAsuAsuAsuAsuAsuAsuAsuAsuAsuAsuAsuAsu
AsuAsuAsuAsuAsuAsuAsuAsuAsuAsuAsuAsuAsuAsuAsuAsuAsuAsuAsuAsuAsuAsuAsuAsu
AsuAsuAsuAsuAsuAsuAsuAsuAsuAsuAsuAsuAsuAsuAsuAsuTghAsuAsuAsuAsuAsuAsuAsu
AsuAsuAsuAsuAsuAsuAsuAsuAsuAsuAxvAsuAsuThhAsuAsuAsuAsuAsuAsuAsuAsuAsuAsu
AsuAsuAsuAsuAsuAsuAsuAsuAsuAsuAsuAsuAsuAsuAsuAsuAsuAsuAsuAsuAsuAsuAsuAsu
AsuAsuAsuAsuAsuAsuAsuTlcAsuAsuTlcAsuTlcTlcAsuAsuTghAsuAsuAsuAsuAsuAsuAsu
AsuAsuAsuAsuAsuAsuAsuAsuTpaTamAsuTmaAsuAsuTdmAsuAsuAsuAsuAsuAsuAsuAsuAsu
AsuAsuAsuAsuAsuPgcPgcPgcPgcPgcPgcPgcPgcPgcPgcPgcPgcAsuAsuAsuAsuAsuAsuAsu
AsuAsuAsuAsuAsuAsuAsuAsuAsuAsuAsuAsuAsuAsuAsuAsuAsuAsuAsuAsuAsuAsuAsuAsu
AsuAsuAsuAsuAsuAsuAsuAsuAsuAsuAsuAsuAsuAsuAsuAsuAsuAsuAsuAsuAsuAsuAsuAsu
