AsuAsuAsuAsuAsuAsuAsuAsuAsuAsuAsuAsuAsuAsuAsuAsuAsuAsuAsuAsuAsuAsuAsuAsu
AsuAsuAsuAsuAsuAsuAsuAsuAsuAsuAsuAsuAsuAsuAsuAsuAsuAsuAsuAsuAsuAsuAsuAsu
AsuAsuAsuAsuAsuAsuAsuAsuAsuAsuAsuAsuAsuAsuAsuAsuAsuAsuAsuAsuAsuAsuAsuAsu
AsuAsuAsuAsuAsuAsuAsuAsuAsuAsuAsuAsuAsuRibRjbAsuRijRpmAsuAsuAsuAsuAsuAsu
AsuAsuAsuAsuAsuAsuAsuAsuAsuAsuAsuAsuAsuAsuAsuAsuAsuAsuAsuAsuAsuAsuAsuAsu
AsuAsuAsuAsuAsuAsuAsuAsuAsuAsuAsuAsuAsuAsuAsuAsuAsuAsuAsuAsuAsuAsuAsuAsu
AsuAsuAsuAsuAsuAsuAsuAsuAsuAsuAsuAsuAsuAsuAsuAsuRaoRemRfmAsuAsuAsuAsuAsu
AsuAsuAsuAsuAsuAsuAsuRimRjmAsuAsuOa8AsuAsuRgjRhdAsuAsuAsuAsuAsuAsuAsuAsu
AsuAsuAsuAsuAsuOd6Og6Og6Og6Og6Og6AsuOg6Og6Og6Og6Og6Og6AsuAsuAsuAsuAsuAsu
AsuAsuAsuAsuAsuAsuAsuAsuAsuRkoAsuAsuAsuRkoAsuAsuAsuAsuAsuAsuAsuAsuAsuAsu
AsuAsuAsuSonAsuAsuAsuAsuAsuAsuAsuAsuAsuAsuRelAsuAsuAsuAsuAsuAsuAsuAsuAsu
AsuAsuAsuAsuAsuAsuAsuAsuAsuAsuAsuAsuAsuAsuAsuAsuAsuAwvAsuAsuAsuAsuAsuAsu
AsuAsuAsuOg6Og6AsuOg6Og6Og6Og6Og6AsuOg6Og6Og6Og6Og6Og6AsuAsuAsuAsuAsuAsu
AsuAsuAsuAsuAsuAsuAsuAsuAsuAsuAsuAsuAsuAsuAsuAsuAsuAsuAsuAsuAsuAsuAsuAsu
