AwwAwwAwwAwwAwwAwwAwwAwwAwwAwwAwwAwwAwwAwwAwwAwwAsuAwwAwwAwwIhaAwwAwwAww
AwwAwwAwwAwwAwwAwwAwwAwwAwwAwwAwwAwwAwwAwwAwwAwwAsuIdbAwwAwwIhbAwwAwwAww
AwwAwwAwwJfdJgdJhdAwwAwwAwwAwwAwwAwwAwwJfeAwwAwwAsuAwwAwwAwwIhbAwwAwwAww
AuvAwwIdbAwwAwwAsuFdlAsuAsuAsuAwwAxvAwwAwwAwwAwwAsuAwwAwwJceIhcAxwAxwAww
AwwAwwAwwQmeAsuAxwKgeAwwAwwAwwAwwAwwAwwAwwAwwAwwAsuAwwAwwJcfIhcAxwJebJfb
AwwFdlAwwAwwAwwAwwAwwJgcAwwAwwAwwAwwAwwAwwAwwHabAsuAwwAwwAxvIhdAwwAwwAww
AwwFdlAwwQleAwwAsuAsuAsuAsuAwwAwwAwwAwwAwwAwwAwwAsuAwwAwwAwwIcbAwwAwwAww
AwwAwwAwwAwwAwwAwwAwwAwwAwwAwwAwwAwwJgeJheAwwAwwAsuAwwAwwAwwAwwAwwIfbAww
AwwFckAwwIdbAwwAwwAwwAwwAwwAwwAwwAwwAwwAwwAwwAwwAwwAwwAwwIeaAwwAwwAwwAww
AwwIcbAwwAwwAwwAwwAsuAsuAsuAwwAwwAwwIokAwwAwwAwwAwwAwwAxwAxwAwwAwwAwwAww
AsuAsuAwwAwwAwwAwwAsuAsuKhdAwwAwwAwwAwwAxwAwwAwwIokAwwAxwAxwAxwAwwAwwAww
AsuAsuIdbAwwAwwAwwKajAwwKcjAwwAxwAxwAxwAxwAxwAxwAxwAxwAxwAxwAxwAwwAwwAww
AwwAwwAwwKheAwwAwwAwwKheAwwAwwAxwAxwAxwAxwAxwAxwAxwAxwAxwAxwAwwAwwAwwAww
AwwAwwAwwAwwAwwAwwAwwAwwAwwAwwAxwAxwAxwAxwAxwAxwAxwAxwAxwAxwAwwAwwAwwAww
