AsuAsuAsuAsuAsuAsuAsuAsuAsuAsuAsuAsuKcjAsuAsuAsuAsuAsuAsuAsuAsuAsuAsuAsu
AsuAsuAsuAsuAsuAsuAsuAsuAsuAsuAsuAsuAsuAsuAsuAsuAsuAsuAsuAsuAsuAsuAsuAsu
AsuAsuAsuAsuAsuAsuAsuAsuAsuAsuAsuAsuAsuAsuAsuAsuAsuAsuAsuAsuAsuAsuAsuAsu
AsuAsuAsuAsuAsuAsuAsuAsuAsuAsuAsuAsuAsuAsuAsuAsuAsuAsuAsuAneAoeApeAsuAsu
AsuAsuAsuAsuAsuAsuAsuAsuAsuAsuAsuAsuAsuAsuAsuAsuAsuAsuAsuAnfAofApfJgdJhd
AsuAsuAsuAsuAsuAsuAsuAsuAsuAsuAsuAsuAsuAsuAsuAsuAsuAsuAsuAngAqfAreApeAsu
AsuAsuAsuAsuAsuAsuAsuAsuAsuAsuAsuAsuAsuAsuAsuAsuAsuAsuAsuAsuAngAogApgAsu
AsuAsuAsuAsuAsuAsuAsuAsuAsuAsuAsuKgcAsuAsuAsuAsuAsuAsuAsuAsuAsuAsuAsuAsu
AsuAsuAsuAsuAsuAsuAsuAsuAsuAsuAsuAsuAsuAsuAsuAsuAsuAsuAsuAsuAsuAsuAsuAsu
AsuAsuAsuAsuAsuAsuAsuAsuAsuAsuAsuAsuAsuAsuAsuAsuAsuAsuAsuAsuAsuAsuAsuAsu
AsuAsuAsuAsuAsuAsuAsuAsuAsuAsuAsuAsuAsuAsuAsuAsuAsuAsuAsuAsuAsuAsuAsuAsu
DlcDlcDlcDlcDmcAsuAsuAsuAsuAsuAsuAsuAsuAsuKaeKbeAsuAsuAsuAsuAsuAsuAsuAsu
AsuAsuAsuAsuAsuDbsDdsDdsDdsDesKfcAsuAsuAsuKfdKbfAsuKgcAsuKamAsuAsuAsuKhd
AsuAsuAsuAsuAsuAsuAsuAsuAsuAsuAsuKhdKgdAsuKagKbgAsuKaeKbeKhdAsuAsuAsuKai
