AsuAsuAsuAsuAsuAsuAsuAsuAsuAsuAsuAsuAsuAsuAsuAsuAsuAsuAsuAsuAsuAsuAsuAsu
AsuAsuAsuAsuAsuAsuGfiGgiGhiAsuAsuAsuAsuAsuAsuAsuAsuAsuAsuAsuAsuAsuAsuAsu
AsuAsuAsuAsuAsuAsuGfjGgjGhjAsuAsuAsuAsuAsuAsuAsuAsuAsuAsuAsuAsuAsuAsuAsu
AsuAsuAsuAsuIoaIpaAsuAsuAsuAsuAsuAsuAsuAsuAsuAsuAsuAsuAsuAsuAsuAsuAsuAsu
AsuAsuAsuAsuIobIpbAsuAsuAsuAmfAsuAsuAsuAsuAsuAsuAsuAsuAsuAsuAsuJfdAsuAsu
AsuAsuAsuAsuAsuAsuAsuAsuAsuAmgAsuAsuIkmIlmAsuAsuAsuAsuAsuAsuAsuAsuAsuAsu
AsuAsuAsuAsuAsuAsuAsuAsuAnhArhAsuAsuIknIlnAsuAsuAsuAsuAsuAsuAsuAsuAsuAsu
AsuAsuAsuAsuAneAoeApeAsuAsuAsuAsuAsuAsuAsuAsuAsuAsuAsuAsuAsuAsuAsuAsuAsu
AsuAsuAsuAsuAnfAofApfAsuAsuAsuAsuAsfAsuAsuAsuAsuAsuAsuAsuAsuAsuAsuAsuAsu
AsuAsuAsuAsuAngAqfAreApeAsuAsuAsuAwhAohAvhIkkAsuAsuAsuAsuAsuAsuAsuAsuAsu
AsuAsuAsuAsuAsuAngAogApgAsuAsuAsuAsuAsuAsuIklAsuAsuAsuAsuAsuAsuAsuAsuAsu
AsuAsuAsuAsuAsuAsuAsuAsuAsuAsuAsuAsuAsuAsuAsuAsuAsuAsuAsuAsuAsuAsuAsuAsu
AsuAsuAsuAsuAsuAsuAsuAsuAsuAsuKigKjgKjgKjgKjgKjgKjgKjgKjgKjgKjgKjgKjgKjg
AsuAsuAsuAsuAsuAsuAsuAsuAsuAsuHamAifAifAifAifAifHalHalHalHalHalHalHalHal
