AcbAcbAcbAcbAcbAcbAcbAcbAcbAbbAcbAcbAdbAcbAcbAcbAcbAcbAcbAcbAcbAcbAcbAcb
AcbAcbAcbAcbAcbAcbAcbAcbAcbAbbAcbAcbAdbAcbAcbAcbAcbAcbAcbAcbAcbAcbAcbAcb
AcbAcbAcbAcbAcbAcbAcbAcbAcbAbbAcbAcbAdbAcbAcbAcbAcbAcbAcbAcbAcbAcbAcbAcb
AcbAcbAcbAcbAcbAcbAcbAcbAcbAbbAcbAcbAdbAcbAcbAcbAcbAcbAcbAcbAcbAcbAcbAcb
AcbAcbAcbAcbAbaAcaAcaAcaMgiAeaAcbAcbAdbAcbAcbAcbAcbAcbAcbAcbAcbAcbAcbAcb
AcdAcdAcdAcdAeaAcbAcbAcbAcbAcbAcbAcbAfaAcaAcaAcaAcaAcaAcaAcaAcaAcaAcaAca
AcbAcbAcbAcbAcbAcbAcbAcbAcbAcbAcbAcbAcbAcbAcbAcbAcbAcbAcbAcbAcbAcbAcbAcb
AcbAcbAcbAcbAcbAcbAcbAcbAcbAcbAcbAcbAcbAcbAcbAcbAcbAcbAcbAcbAcbAcbAcbAcb
AcbAcbAcbAcbAcbAcbAcbAcbAcbAcbAcbAcbAcbAcbAcbAcbAcbAcbAcbAcbAcbAcbAcbAcb
AcbAcbAcbAcbAcbAcbAcbAcbAcbAcbAcbAcbAcbAcbAcbAcbAcbAcbAcbAcbAcbAcbAcbAcb
AcbAcbAcbAcbAcbAcbAcbAcbAcbAcbAcbAcbAcbAcbAcbAcbAcbAcbAcbAcbAcbAcbAcbAcb
AcbAcbAcbAcbAcbAcbAcbAcbAcbAcbAcbAcbAcbAcbAcbAcbAcbAcbAcbAcbAcbAcbAcbAcb
AcbAcbAcbAcbAcbAcbAcbAcbAcbAcbAcbAcbAcbAcbAcbAcbAcbAcbAcbAcbAcbAcbAcbAcb
AcbAcbAcbAcbAcbAcbAcbAcbAcbAcbAcbAcbAcbAcbAcbAcbAcbAcbAcbAcbAcbAcbAcbAcb
