AccAccAccAccAccAccAccAccAccAccAifAifAifAifAifAifAifAifAifAifAifAifAifAif
AccAccAccAccAccAccAccAccAccAccAifAifAifAifAifAifAifAifAifAifAifAifAifAif
AccAccAccAccAccAccAccAccAccAccAifAifAifAifAifAifAifAifAifAneAifAifAifAif
AccAccAccAccAccAccAccAccAccAccAifAifAifAifAifAifAifAifAifAifAifAifAifAif
AccAccAccAccAbaAcaAcaAcaAcaAcaAhfAifAifAifAifAifAifAifAifAifAifAifAifAif
AcaAcaAcaAcdAeaAccAccAccAccAccAhfAifAifAifAifAifAifAifAifAifAifAifAifAif
AccAccAccAccAccAccAccAccAccAccAhfAifAifAifAifAifAifAifAifAifAifAifAifAif
AccAccAccAcbAccAccAccAccAccAccAhfAifAifAifAifAifAifAifAifAifAifAifAifAif
AccAccAcbAcbAccAccAccAccAccAccAhfAifAifAifAifAifAifAifAifAifAifAifAifAif
AccAccAccAccAccAccAccAccAccAccAhfAifAifAifAifAifAifAifAifAifAifAifAifAif
AccAccAccAccAccAccAccAccAccAccAhfAifAifAifAifAifAifAifAifAifAifAifAifAif
AccAccAccAccAccAccAccAccAccAccAhfAifAifAifAifAifAifAifAifAifAifAifAifAif
AccAccAccAccAccAccAccAccAccAccAhfAifAifAifAifAifAifAifAifAifAifAifAifAif
AccAccAccAccAccAccAccAccAccAccAhfAifAifAifAifAifAifAifAifAifAifAifAifAif
