AxwAxwAxwAxwAxwAxwAxwAxwAxwAxwAxwAxwAxwAxwAxwAxwAxwAxwAxwAxwAxwAxwAxwAxw
AxwAxwAxwAxwAxwAxwAxwAxwAxwAxwAxwAxwAsuAsuAxwAxwAxwAxwAxwAxwAxwAxwAxwAxw
AxwAxwAxwAxwAxwAxwAxwAxwAsuAsuAsuAsuAsuAsuAsuAsuAsuAsuAsuAsuAsuAsuAsuAsu
AxwAxwAxwAxwAxwAxwAxwAxwAsuAsuAsuAsuAxwAxwAsuKakKbkKckKdkAsuAsuAsuAsuAsu
AxwAxwAxwIofAxwAxwAxwAxwAxwAxwAxwAxwAxwAxwAxwKalKblKclKdlAxwAxwAxwAwvAxw
AxwAxwAxwAxwAxwAxwAxwAxwAxwAxwAxwAxwAxwAxwAxwKamKbmKcmKdmAxwAxwAxwAsuAxw
AxwAxwAxwAxwAxwAxwAxwAxwAxwAxwAxwAxwAxwAxwAxwAxwAxwAxwAxwAxwAxwAxwAxwAxw
AxwAxwAxwAxwAxwAxwAxwAxwAxwAxwAxwAxwAxwAxwAxwAxwAxwAxwAxwAxwAxwAxwAxwAxw
AxwAxwAxwAxwAxwAxwAxwAsuAxwAxwAxwAxwAxwAxwAxwAxwAsuAxwAxwAxwAxwAxwAxwAxw
AxwGpiAxwAsuAxwAsuAxwAsuAxwIjgAwwAxwAxwAxwAxwAxwAsuAxwAxwAxwAxwAsuAxwAxw
AxwGpjAxwAsuAsuAsuAxwAxwAxwAxwAxwAxwAxwIjgAxwAxwAxwAxwAxwAxwAxwAsuAxwAxw
AxwGplAxwAxwAxwAxwAxwAxwAxwAxwAxwAxwAxwAwwAxwAxwAxwAxwAxwAxwAxwAxwGnkAxw
AxwAxwAxwAxwAxwGlkGmkAxwAxwAxwAxwAxwAxwAxwAxwAxwAxwAxwAxwAxwAxwAxwGnlAxw
AxwAxwAxwAxwAxwGllGmlAxwAxwAxwAxwAxwAxwAxwAxwAxwAxwAxwAxwAxwAxwAxwAsuAxw
