AsuAsuAsuAsuAsuAsuAsuAsuAsuAsuAsuAsuAsuAsuAsuAsuAsuAsuAsuAsuAsuAsuAsuAsu
AsuAsuAsuAsuAsuAsuAsuAsuAsuAsuAsuAsuAsuAsuAsuAsuAsuAsuAsuAsuAsuAsuAsuAsu
AsuAsuAsuAsuAsuAsuAsuAsuJfnJfmJfnJgjAsuAsuJejJfnJfmJfnJfjJfnJfnJfnJfjJfn
AsuAsuAsuAsuAsuAsuAsuAsuJfoJfoJfoJgoAsuAsuJeoJfoJfoJfoJfkJfoJfoJfoJfkJfo
AsuAsuAsuAsuAsuAsuAsuAsuAsuAsuAsuAsuAsuAsuAsuAsuAsuAsuAsuAsuAsuAsuAsuAsu
AsuAsuAsuAsuAsuAsuAsuAsuAsuAsuAsuAsuAsuAsuAsuAsuAsuAsuAsuAsuAsuAsuAsuAsu
AsuAsuAsuAsuAsuAsuAsuAsuAsuAsuAsuAsuAsuAsuAsuAsuAsuAsuAsuAsuAsuAsuAsuAsu
AsuAsuIniIofAsuAsuAsuAsuAsuAwwAwwAwwAwwAsuAsuAsuAsuAsuAsuAsuAsuAsuAsuAsu
AsuAsuAsuAsuAsuAsuAsuAsuAsuAsuAsuAsuAsuAsuAsuAsuAsuAsuAsuAsuAsuAsuAsuAsu
DdkDdkDdkDekAsuAsuAsuAsuAsuAsuAsuAsuAsuAsuAsuAsuAsuAsuAsuAsuAsuAsuAsuAsu
AsuAsuAsuAsuAsuAsuAsuAsuAsuAsuAsuAsuAsuAsuAsuAsuAsuAsuAsuAsuAsuAsuAsuAsu
AsuAsuAsuAsuDokDpkDpkDpkDrkAsuAsuAsuAsuAsuAsuAsuAsuAsuAsuAsuDj0Dl0Dl0Dl0
AsuAsuAsuAsuAsuAsuAsuAsuAsuAsuAsuAsuAsuAsuAsuAsuAsuAsuAsuAsuAsuAsuAsuAsu
AsuAsuAsuAsuAsuAsuAsuAsuAsuAsuAsuAsuAsuDbsDdsDdsDdsDdsDdsDesAsuAsuAsuAsu
