AcbAcbAcbAcbAcbAcbAcbAifAifAcbAcbAcbAcbAcbAcbAcbAcbAcbAcbAcbAcbAcbAcbAcb
AcbAcbAcbAcbAcbAcbAcbAifAifAcbAcbAcbAcbAcbAcbAcbAcbAcbAcbAcbAcbAcbAifAcb
AcbAcbAcbAcbAcbAcbAcbAifAifAcbAcbAcbAcbAcbAcbAcbAcbAcbAcbAcbAcbAcbAifAcb
AcbAcbAcbAcbAcbAcbAcbAifAifAifAifAifAtrAvrAifAifAifAifAifAifAifAifAifAcb
AcbAcbAcbAcbAcbAcbAcbAifAifAifAifAifAtsAvsAifAifAifAifAifAifAifAifAifAcb
AcaAcbAcaAcaAcaAcaAcaAcaAcaAcaAcaAcaAeaAfaAcaAcaAcaAcaAcaAcaAcaAcaAcaAca
AcbAcbAcbAcbAcbAcbAcbAcbAcbAcbAcbAcbAcbAcbAcbAcbAcbAcbAcbAcbAcbAcbBbjAcb
AcbAcbAcbAcbAcbAcbAcbAcbAcbAcbAcbAcbAcbAcbAcbBbjAcbAcbAcbAcbAcbAcbAcbAcb
AcbAcbAcbAcbAcbAcbAcbAcbAcbAcbBbjAcbAcbAcbAcbAcbAcbAcbAcbAcbAcbAcbAcbAcb
AcbAcbAcbAcbAcbAcbAcbAcbAcbAcbAcbAcbAcbAcbAcbAcbAcbAcbAcbAcbAcbAcbAcbAcb
AcbAcbAcbAcbAcbAcbAcbAcbAcbAcbAcbAcbAcbAcbAcbAcbAcbAcbAcbAcbAcbAcbAcbAcb
AcbAcbAcbAcbAcbAcbAcbAcbAcbAcbAcbAcbAcbAcbAcbAcbAcbAcbAcbAcbAcbAcbAcbAcb
AcbAcbAcbAcbAcbAcbAcbAcbAcbAcbAcbAcbAcbAcbAcbAcbAcbAcbAcbAcbAcbAcbAcbAcb
AcbAcbAcbAcbAcbAcbAcbAcbAcbAcbAcbAcbAcbAcbAcbAcbAcbAcbAcbAcbAcbAcbAcbAcb
